1,1,1,1,1,1,1,1,1,1,1,1,1,1,1,1,1,1,1,1,1,1,1,1
1,1,1,1,1,1,1,1,1,1,1,1,1,1,1,1,1,1,1,1,1,1,1,1
1,1,1,1,1,1,1,1,1,1,1,1,1,1,1,1,1,1,1,1,1,1,1,1
1,1,1,1,1,1,1,1,1,1,1,1,1,1,1,1,1,1,1,1,1,1,1,1
1,1,1,1,8,0,0,0,0,0,0,0,0,0,0,0,0,0,13,1,1,1,1,1
1,1,1,1,0,0,0,3,2,2,2,2,1,1,1,1,1,0,0,1,1,1,1,1
1,1,1,1,0,0,3,1,2,0,0,0,0,0,0,0,2,3,1,1,1,1,1,1
1,1,1,1,0,0,1,1,2,0,1,1,0,1,1,0,2,0,0,1,1,1,1,1
1,1,1,1,0,0,1,2,2,0,1,8,0,1,0,0,2,0,0,1,1,1,1,1
1,1,1,1,0,0,0,0,2,0,1,1,1,1,0,0,0,2,2,2,2,3,12,1
1,1,1,1,0,0,2,0,1,0,0,0,0,1,0,0,0,0,0,1,1,1,1,1
1,1,1,1,0,0,2,0,1,1,0,0,0,1,0,2,2,2,0,1,1,1,1,1
1,1,1,1,0,0,2,0,0,2,0,0,0,1,0,2,3,2,0,1,1,1,1,1
1,1,1,1,0,2,0,0,1,1,0,0,0,1,0,3,2,2,0,1,1,1,1,1
1,1,1,1,0,1,7,0,0,0,3,0,0,1,8,1,0,0,9,1,1,1,1,1
1,1,1,1,1,1,5,1,1,1,1,5,1,1,1,1,1,1,1,1,1,1,1,1
1,1,1,1,1,1,1,1,1,1,1,1,1,1,1,1,1,1,1,1,1,1,1,1
1,1,1,1,1,1,1,1,1,1,1,1,1,1,1,1,1,1,1,1,1,1,1,1
1,1,1,1,1,1,1,1,1,1,1,1,1,1,1,1,1,1,1,1,1,1,1,1
1,1,1,1,1,1,1,1,1,1,1,1,1,1,1,1,1,1,1,1,1,1,1,1
