1,1,1,1,1,1,1,1,1,1,1,1,1,1,1,1,1,1,1,1,1,1,1,1,1,1,1,1,1,1,1,1,1,1,1,1,1
1,1,1,1,1,1,1,1,1,1,1,1,1,1,1,1,1,1,1,1,1,1,1,1,1,1,1,1,2,2,2,2,2,2,2,1,1
1,1,1,1,1,1,1,1,1,1,1,1,1,1,1,1,1,1,1,1,1,1,1,1,1,1,1,1,0,1,1,1,1,1,1,1,1
1,1,1,1,1,1,1,1,1,1,1,1,1,1,1,1,1,1,1,1,1,1,1,1,1,1,1,1,0,1,1,1,1,1,1,1,1
1,1,13,0,1,0,0,0,0,0,0,0,0,0,0,0,0,0,0,0,0,0,0,0,1,0,0,0,0,1,5,0,0,0,1,1,1
1,1,1,0,1,0,0,0,0,0,0,0,0,0,0,0,0,0,0,0,0,0,0,0,1,0,0,0,0,1,0,0,0,0,1,1,1
1,1,1,0,0,0,1,1,1,1,1,1,0,1,1,1,1,1,1,10,1,1,1,1,1,1,1,1,0,1,10,0,0,0,1,1,1
1,1,1,0,1,1,1,5,0,0,0,1,0,1,0,10,0,0,0,10,0,0,0,0,0,0,0,0,0,3,10,0,0,0,1,1,1
1,1,1,0,1,0,0,0,1,0,0,1,0,1,4,10,0,0,0,10,0,0,0,4,1,1,1,1,1,1,10,0,0,0,1,1,1
1,1,1,0,1,0,4,0,1,0,0,1,0,1,0,10,0,10,0,0,0,10,0,0,1,0,5,0,0,0,0,0,0,0,1,1,1
1,1,1,0,1,0,1,0,1,1,0,0,0,0,0,0,0,10,0,0,0,10,1,1,1,1,1,1,0,0,0,0,0,0,1,1,1
1,1,1,0,1,0,0,1,0,1,1,1,1,1,1,1,1,10,1,1,1,10,0,0,0,0,0,1,0,0,0,0,0,0,1,1,1
1,1,1,0,1,0,0,1,0,0,0,0,0,0,0,0,0,0,0,0,0,8,0,0,0,0,0,1,0,0,0,0,0,0,1,1,1
1,1,1,1,1,0,0,0,0,0,,0,0,0,0,0,0,10,10,10,10,10,1,1,1,1,0,1,0,0,0,0,0,0,1,1,1
1,1,1,0,0,0,0,0,0,0,0,0,0,0,0,0,0,1,0,0,0,10,1,10,1,0,0,1,0,0,0,0,0,0,1,1,1
1,1,1,0,0,0,0,0,0,4,0,0,0,0,0,0,0,1,0,1,0,10,1,4,1,0,0,1,0,0,0,0,0,5,1,1,1
1,1,1,0,0,0,0,0,0,0,0,0,0,0,0,0,7,1,9,1,0,10,1,10,1,0,0,0,0,0,0,0,0,0,1,1,1
1,1,1,0,0,0,0,0,0,0,0,0,0,0,0,0,1,1,1,1,0,10,1,4,1,0,0,0,0,0,0,0,0,0,1,1,1
1,1,1,0,0,0,0,0,0,0,0,0,0,0,0,0,0,1,0,0,0,10,1,1,1,0,0,0,0,0,0,0,0,0,1,1,1
1,1,1,0,0,0,0,0,0,1,1,1,1,1,1,1,1,1,0,1,0,10,10,10,0,0,0,0,0,0,0,0,0,0,1,1,1
1,1,1,0,0,0,0,0,0,0,0,0,0,0,0,0,0,0,0,1,0,4,10,10,0,0,0,0,0,0,1,1,1,1,1,1,1
1,1,1,0,0,0,0,0,0,0,0,0,0,0,0,0,0,0,0,1,0,0,4,10,0,0,0,0,0,0,11,11,11,11,1,1,1
1,1,1,0,0,0,0,0,0,0,0,0,0,0,0,0,0,0,0,1,0,0,0,10,0,0,0,0,0,0,0,0,0,0,1,1,1
1,1,1,0,0,0,0,5,0,0,0,0,0,0,0,0,0,0,0,1,0,0,0,10,0,1,0,0,0,0,0,0,11,0,1,1,1
1,1,1,0,0,0,0,0,0,0,0,0,0,0,0,0,0,0,0,1,0,10,10,8,0,1,0,0,0,0,0,2,11,8,1,1,1
1,1,1,0,0,0,0,0,0,0,0,0,0,0,0,0,0,0,0,10,0,0,0,0,0,1,0,0,0,0,0,0,11,11,1,1,1
1,1,1,0,0,0,0,0,0,0,0,0,0,0,0,3,0,0,0,10,0,0,0,0,0,1,0,0,0,0,0,0,0,7,1,1,1
1,1,1,1,1,1,1,1,1,1,1,1,1,1,1,1,1,1,1,1,1,1,1,1,5,1,1,1,1,11,11,11,5,1,1,1,1
1,1,1,1,1,1,1,1,1,1,1,1,1,1,1,1,1,1,1,1,1,1,1,1,1,1,1,1,1,11,11,5,1,1,2,1,1
1,1,1,1,1,1,1,1,1,1,1,1,1,1,1,1,1,1,1,1,1,1,1,1,1,1,1,1,1,11,5,1,1,1,2,1,1
1,1,1,1,1,1,1,1,1,1,1,1,1,1,1,1,1,1,1,1,1,1,1,1,1,1,1,1,1,5,1,1,1,1,1,1,1
1,1,1,1,1,1,1,1,1,1,1,1,1,1,1,1,1,1,1,1,1,1,1,1,1,1,1,1,1,1,1,1,1,1,1,1,1
